
NO ./Textures/wood0.xpm
SO ./Textures/wood1.xpm
EA ./Textures/wood2.xpm
WE ./Textures/wood3.xpm

F 0,0,255
C 225,0,0


1111111111111111111111111
1110000000000000010000001
1000000000000000100000001
1000000000000011000000001
1000000000001000000000001
10000001E1010000000000111
1000000010001000000000001
1000000000000000000000001
1000000000000000000000001
1000000000000000000000001
1111111111111111111111111
