
F 255,222,255
C 225,30,050

NO ./Textures/wood0.xpm
SO ./Textures/wood1.xpm
EA ./Textures/wood2.xpm
WE ./Textures/wood3.xpm


    11111111111111
111111000E0011111111
 1111111001000000001
 111100001111111111111
111111110000011111
100000010001111111111
 11110000011  10010001
1000000000011111111111
1111111111111
