
NO ./Textures/wood0.xpm
SO ./Textures/wood1.xpm
EA ./Textures/wood2.xpm
WE ./Textures/wood3.xpm

F 34,38,38
C 47,79,79



111111111111111111111111
1000000000010000010000001
10000000000111011 1100001
1000000000000011010N00001
1000000000001000000000001
1000000101010000000000111
1000000010001000000000001
1000000000000000000000001
1000000000000000000000001
1000000000000000000000001
1111111111111111111111111
