
NO ./Textures/wood0.xpm
SO ./Textures/wood1.xpm
EA ./Textures/wood2.xpm
WE ./Textures/wood3.xpm


F 255,222,255
C 225,30,050


1111111111111111111111111
1000000000000000000000001
1000000000000000000000001
1000000000000000000000001
1000000000000000000000001
1000000000000000000000001
1000000E00000000000000001
1000000000000000000000001
1000000000000000000000001
1000000000000000000000001
1111111111111111111111111
