
NO ./Textures/wood0.xpm
SO ./Textures/wood1.xpm
EA ./Textures/wood2.xpm
WE ./Textures/wood3.xpm


F 255,222,255
C 225,30,050


11111111111111111111111111111111111111
10000011000010000000000000000000000001
10000100000010000000000000000000000001
11110000001010000000000000000000000001
10001001000010000000000000000000000001
10000000000000000000000000000000000001
10000000000000000000E00000000000000001
10000000000000000000000000000000000001
11111100011110000000000000000000000001
10000000000000000000000000000000000001
11111111111111111111111111111111111111
